The Crane
0,10
1,10
-----------------------------
#Start Platform
0,14,1:0:1
1,14,1:0:1
0,13,1:0:1
1,13,1:0:1
0,12,1:0:1
1,12,1:0:1
0,11,1:0:1
1,11,1:0:1

#Floating Platform
5,8,1:0:1
6,8,1:0:1
7,8,1:0:1

#Landing Platform
9,13,1:0:1
10,13,1:0:1
11,13,1:0:1
12,13,1:0:1

#Structure for Climbing
12,1,2:0:1
13,1,1:0:1
14,1,1:0:1
15,1,2:0:1
16,1,2:0:1
17,1,2:0:1
18,1,2:0:1
16,2,2:0:1
16,3,2:0:1
16,4,2:0:1
16,5,2:0:1
16,6,2:0:1
16,7,2:0:1
16,8,2:0:1
16,9,2:0:1
16,10,2:0:1
16,11,2:0:1

#Spikes on floor
2,14,3:0:1
3,14,3:0:1
4,14,3:0:1
5,14,3:0:1
6,14,3:0:1
7,14,3:0:1
8,14,3:0:1
9,14,3:0:1
10,14,3:0:1
11,14,3:0:1
12,14,3:0:1
13,14,3:0:1
14,14,3:0:1
15,14,3:0:1
16,14,3:0:1
17,14,3:0:1

#End Platform
18,14,1:0:1
19,14,1:0:1
18,13,1:0:1
19,13,1:0:1
18,12,1:0:1
19,12,1:0:1
18,11,1:0:1
19,11,1:0:1
18,10,1:0:1
19,10,1:0:1
18,9,1:0:1
19,9,1:0:1
18,8,1:0:1
19,8,1:0:1
18,7,1:0:1
19,7,1:0:1
18,6,1:0:1
19,6,1:0:1
18,5,1:0:1
19,5,1:0:1
18,4,1:0:1
19,4,1:0:1

#End Zone
19,3,6:0:0
18,3,6:0:0